12 13
|||| ||||||||
||||    |||||
|||| ||  ||||
||||   |  |||
|||||  || |||
|||||| || |||
||||||    |||
||||||    |||
||||   | ||||
     ||  ||||
|| |    |||||
|| ||||||||||