12 13
|||| ||||||||
||||    |||  
|||| ||  || |
||||   |    |
|||||  || |||
|||||| || |||
||||||    |||
||||||     ||
||||   | | ||
|    ||  | ||
|| |    ||   
|||||||||||||