12 13
|||| ||||||||
||||    |||||
|||| ||  ||||
||||   |  |||
|||||  || |||
|||||| || |||
||||||    |||
||||||     ||
||||   | | ||
|    ||  | ||
|| |    || ||
|| ||||||| ||